F = RAM
W = working registry
D = data
A = address
w = write
r = read
L = literal
------------

global reset = R
every cycle write = W
second cycle write = Z

Memory:
F write = green, clock write = uranium ore
W write = blue, clock write = iron ore
F read  = yellow
W read  = pink

Literal = V
ALU result = satellite

F Data in = F
F Data out = G
F address w = A
F address r = B

W Data in = X
W Data out = Y

ALU to W = K
F to W   = cyan
L to W   = copper plate
in1 to W  = rocket
in2 to W  = magazine

ALU to F = L
W to F   = white
L to F   = M
in1 to F  = explosive rocket
in2 to F  = piercing magazine

L to AwF = grey
L to ArF = black

Program counter:
Load PC = steam
value to PC = water

Incr to PC = crude oil
Conditional false = green check & lubricant
program count = C

Function call stack:
Stack & pointer write = white sp, clock write = red sp
increment pointer = green science pack
decrement pointer/load call stack to pc = black science pack
pointer = P

Variable scope stack:
Stack = uraniun fuel cell, clock write = used up ufc
pointer write = uraninum-235, clock write = uraninum-238
increment pointer = blue science pack
decrement pointer = purple science pack
pointer = Q

ALU:
Input 1/2 = 1/2

ADD  = repair pack
SUB  = boiler
EQ   = steam engine
GRT  = solar panel
LESS = accumulator
MUL  = nuclear reactor
DIV  = heat pipe
INCR = heat exchange
DECR = steam turbine
MOD  = burner mining drill
ROR  = electric mining drill
ROL  = offshore pump
AND  = pumpjack
OR   = stone furnace

W to ALU1 = speed1
F to ALU1 = eff1
L to ALU1 = prod1
W to ALU2 = speed2
F to ALU2 = eff2
L to ALU2 = prod2

I/O
out1/out2 value = 3/4
in1/in2 value = 5/6

L to OUT1 = armor1
F to OUT1 = armor2
W to OUT1 = grenade

L to OUT2 = armor3
F to OUT2 = armor4
W to OUT2 = cluster grenade

OUT1 w = battery1, clock write = energy shield 1
OUT2 w = battery2, clock write = energy shield 2

PULSE = belt immunity, clock write = exoskeleton

IGPU
render = iron gear wheel
clear = engine unit
buffer1 w = copper cable, clock write = iron stick
buffer1 data = processing unit
W to bf1 = empty barrel
F to bf1 = electronic circuit
L to bf1 = advanced circuit
